# This puzzle is unsolvable
10
 54  12  37  77  17   3  80  88   2  46
  0  70  45  69   4  87  49   8  42   7
 31  33  81   5  78  51   6  48  66  73
 71  95  34  41  39  43  97  29  13  90
 32  16  76  65  14  44  22  19  36  67
 83  53  85  26  93  55  47  60  38  89
 98  72  68  57  40  10  63   9  92  23
 82  86   1  58  18  75  74  20  56  84
 62  28  79  27  30  50  64  24  15  21
 35  99  94  25  59  96  61  11  52  91
