# This puzzle is solvable
10
 88  98  44  33  22  43  62  64  10  13
 36  63  68  65  48  46  73  23  12  45
 84  83  60  51  76  26  70  69  11  42
 96  99  90  72  85  50  20  52  15  40
  3  29  32  57  38  53   2  93   4  31
 47  34  80  25  61   9  97   6   0   5
 55  28   7  81  41  71  49  67   8  75
 95  14  56  30  17  16  35  86  24  18
 87  37  59  21  78  27  19   1  91  77
 94  79  58  66  39  82  89  54  74  92
