# This puzzle is unsolvable
10
 38  67  33  85   8  48   2  12  43   7
 66  71  63  87  76  64  31  92   1  23
 28  97  82   4  30  91  40  69  13  21
 39  95  45  32  79  20  46   5  65  96
 41   3   6  68  54  74  77  94  52  98
 44  89  29  36  26  73  78  37  11  61
 35  60  56  59   9  42  24  99  15  80
 93  62  27  84  14  19  86  22  75  70
 51   0  53  34  50  17  18  81  16  83
 72  10  55  25  88  49  57  58  90  47
