# This puzzle is unsolvable
20
208   1  76 255   6   0 207  85 209 307 212   9 155 213  15 214 161 159  18  94
  2  74 144  78 147   5 148  82  84 210 152 265  13  90  86  92  16  22  17  19
211  73 143  72 206 146   7  81 151  83  10 156 150 215  93  11  26  12 102  20
199   3  75 198   4 304 258 263 308 309 264 154 306 216 218 160  23 162  24  96
 70 301  77 204 202 259 203 399 303 344 305  89  88  91 262 153  98  25  95  21
336 142  79 145 256   8  80 299 261 388 353 370 266 268 348 267 158  30 157 220
257  71 254 260 140 339 338 335 302  14 345 341 372 342 273  28 217 219 163  99
 69 139 201 200 250 300 337 340 385 369 149 343 368 311 166 165  97 269 222 100
136 196 141 205 334 137 294 366 363 295 397 298  87 371 310 221 164 347 167 101
251 193 252 138 195 296 360 297 396 354 381 271 315 386 313 312 225 274 168  29
 65 133  68 245 394 333 362 384 365 350 398 324 377 314 223 275 171 104  31 106
134  57 248 197 249 331 391 253 387 378 376 390 346 392 349 316 224 229 103 169
129  66  67 292 364 383 291 395 382 374 375 352 277 317 318 389 111 230 270  27
293 128 194 290 332 356 361 379 325 329 285 323 276 272 279 226  47  32 170 105
122 242  63 358 241 240 132 184 326 380 367 357 319 281 232 180 280  34  36  35
130 190  64  55 187 125 236 355 359 322 393 284 351 320 109 321 172 227 113  33
 53  59  61 244 188 288 191 287 237 123 117 234 176 116 177 282 228 231 108 110
 58 135 246 131 126 185 247 186 328 373  51 183 178 283 235 114 233 175  37 107
 60 289 189 327 192 127  48 182 121 239  49 119 118  44 115 278 174 173  41  39
243  62  56  52 330  54  50 120 286 124 238 181  46 179  45  42 112  38  43  40
