# This puzzle is solvable
10
 83  39  47  91   4  35   6  42  13  25
 77  84  40  86  54  15   0  63  41  10
 90  36  51   8  98  33  68  50   7  14
 61  37  67   5  80  88  65  72  85  30
 29  87  74  73  55  82  56  75  69  49
 64   2  53  57  79  11  93  97  12  19
 95  22  44   1  94  21  66  28  18   9
  3  62  58  38  46  45  48  20  71  78
 96  32  26  23  43  17  76  16  24  52
 34  89  81  99  59  31  92  60  70  27
